Empfangs- zimmer	Empfangszimmer
Wen- dungen	Wendungen
<p>Sagittal- umfang,	<p>Sagittalumfang,
her- vor,	hervor,
anthropo- logisch	anthropologisch
erüs- gedüeftelt	erüsgedüeftelt
Wisse- schaft	Wisseschaft
sech- zehn	sechzehn
ge- meint,	gemeint,
ver- stehn?!	verstehn?!
For- schung	Forschung
per- mets	permets
ge- borener	geborener
Sachse- bund.	Sachsebund.
nüs- schmisse,	nüsschmisse,
d’sächs- isch	d’sächsisch
Spott- vöujel	Spottvöujel
organi- siert	organisiert
Knepp- chen,	Kneppchen,
Gross- mamme	Grossmamme
Centi- metermass	Centimetermass
Ge- läjeheit	Geläjeheit
Mit- arweiterschaft	Mitarweiterschaft
Centi- meter	Centimeter
Centi- meter!	Centimeter!
Experi- mente	Experimente
ex- küsiere,	exküsiere,
e-n-Ent- deckung	e-n-Entdeckung
offi- ziell	offiziell
Medi- ziner!	Mediziner!
ver- sichert	versichert
zeruck- denk,	zeruckdenk,
Chefre- dakteur	Chefredakteur
d’Bekannt- schaft	d’Bekanntschaft
Win- ter	Winter
l’in- viteras	l’inviteras
al- sacien“.</emph>	alsacien“.</emph>
Ver- dienschte	Verdienschte
rend="italic">d’Fan- fare</emph>	rend="italic">d’Fanfare</emph>
ha- wich	hawich
ver- schwäjert	verschwäjert
z'Midda- esse-n-in</p>	z'Middaesse-n-in</p>
deci- diert	decidiert
Schwowe- n-uff	Schwowen-uff
erüs- thät	erüsthät
e-n-In- tresse	e-n-Intresse
zelle- wäj	zellewäj
erüs- kumme.	erüskumme.
ver- ratzt,	verratzt,
Nooch- forschunge	Noochforschunge
er- fahrt,	erfahrt,
ver- wundert	verwundert
Wich- tiges	Wichtiges
Er- freulicheres	Erfreulicheres
Er- freulicheres	Erfreulicheres
Sachsen- bundes,	Sachsenbundes,
Verwandt- schaft	Verwandtschaft
Üs- sichte!	Üssichte!
rend="italic">Au- guste</emph>	rend="italic">Auguste</emph>
Pro- fesser	Professer
aller- wenigschte	allerwenigschte
Gsell- schaft	Gsellschaft
ein- dhuen,	eindhuen,
Nätz- fädel	Nätzfädel
sym- patisch	sympatisch
d’r- for	d’rfor
<stage>(Enttäu- schung	<stage>(Enttäuschung
üs- zesetze	üszesetze
Zwanzig- marikstüeckle	Zwanzigmarikstüeckle
ver- lockends	verlockends
fran- zöschs	französchs
fian- cirt	fiancirt
lätz- gedrähjte,	lätzgedrähjte,
d’Schäddel- bildung	d’Schäddelbildung
Büre- familli.</p>	Bürefamilli.</p>
lätzge- drähjte	lätzgedrähjte
jugend- liches	jugendliches
selbstge- bundene	selbstgebundene
Anwesen- den):</stage>	Anwesenden):</stage>
-n-Ur- sach	-n-Ursach
Kali- fornie	Kalifornie
Bougi- val,</emph>	Bougival,</emph>
spöt- telsch	spöttelsch
schla- gend)</stage>	schlagend)</stage>
ver- dorwe	verdorwe
d’mensch- lich	d’menschlich
franco- allemande</emph>	francoallemande</emph>
nüs- schmisse,	nüsschmisse,
ver- ratzt...</p>	verratzt...</p>
desser- tiere?...	dessertiere?...
<stage>(über- reicht	<stage>(überreicht
be- müht	bemüht
Verbeu- gung	Verbeugung
Ge- sundheit	Gesundheit
Affen- schande!	Affenschande!
ge- fahren	gefahren
zurückge- zogen.	zurückgezogen.
zu- sammenhalten,	zusammenhalten,
Sachse- bund!	Sachsebund!
De- peschen	Depeschen
Grin- singer,	Grinsinger,
ge- worden?!	geworden?!
rend="italic">Grin- singers</emph>	rend="italic">Grinsingers</emph>
lang- strecken,	langstrecken,
mit- gehen	mitgehen
ver- wechselsch,	verwechselsch,
Schäch- telchens):</stage>	Schächtelchens):</stage>
Schäch- telchen	Schächtelchen
vor- laifig	vorlaifig
ge- messe,	gemesse,
Ent- deckung	Entdeckung
Schädel- bildung	Schädelbildung
z’Midaa- esse	z’Midaaesse
Durch- schnittskopf.</p>	Durchschnittskopf.</p>
Durchschnitts- kopf	Durchschnittskopf
wisse- schaftlich	wisseschaftlich
be- tracht	betracht
ge- trunke	getrunke
ver- derbsch	verderbsch
funktio- niert	funktioniert
wisse- schaftliche,	wisseschaftliche,
mensch- liche	menschliche
weg- nemme,	wegnemme,
ein- fach	einfach
erüs- gebrocht,	erüsgebrocht,
Manns- lytte	Mannslytte
ein- mol	einmol
ere- n-üsgsproche?</p>	eren-üsgsproche?</p>
e-n- Uffreijung	e-nUffreijung
Meter- mass	Metermass
Um- fang	Umfang
rend="italic">made- moiselle</emph>	rend="italic">mademoiselle</emph>
welle- n-e	wellen-e
Wisse- schaft	Wisseschaft
anthropolo- gische	anthropologische
üsserordent- lich	üsserordentlich
e-n-even- tuelli	e-n-eventuelli
ge- schehen.)</stage>	geschehen.)</stage>
ver- öffentliche,	veröffentliche,
Uewe- raschung	Ueweraschung
Über- raschung	Überraschung
Braten- rock	Bratenrock
mit- zuteilen,	mitzuteilen,
Grin- singer	Grinsinger
ge- schlagen	geschlagen
zu- geben,	zugeben,
Prä- sident	Präsident
Krieger- vereine,	Kriegervereine,
Wissen- schaft,	Wissenschaft,
bewerk- stelligt,	bewerkstelligt,
aus- füllt,	ausfüllt,
Knepp- chen)</stage>	Kneppchen)</stage>
klass- ischen	klassischen
Deutsch- land	Deutschland
hin- zustellen	hinzustellen
<stage>(auf- und	<stage>(aufund
ver- mutlich	vermutlich
Beleidi- gung	Beleidigung
aus- gesprochenen	ausgesprochenen
ge- sagt	gesagt
Er- ziehung.	Erziehung.
Nach- forschungen	Nachforschungen
ver- breiteter	verbreiteter
er- klären.</p>	erklären.</p>
Unter- suchungen!	Untersuchungen!
Ver- fügung.</p>	Verfügung.</p>
hei- ligsten	heiligsten
ge- mietliche	gemietliche
sicher- lich	sicherlich
ent- schuldigt	entschuldigt
Nun- dedié’s	Nundedié’s
Vor- stand	Vorstand
angenom- men	angenommen
Licht- und	Lichtund
ver- lobt?!	verlobt?!
üewwer- gschnappt?</p>	üewwergschnappt?</p>
Frank- rich	Frankrich
Dokter- arweit	Dokterarweit
telepho- niert	telephoniert
rend="italic">adhé- sion,	rend="italic">adhésion,
rend="italic">Jean- nette</emph>	rend="italic">Jeannette</emph>
con- naissance	connaissance
Mes- demoiselles,	Mesdemoiselles,
Grin- singer</emph>	Grinsinger</emph>
ab- geloffe,	abgeloffe,
rend="italic">d’Fan- fare</emph>	rend="italic">d’Fanfare</emph>
Grin- singer,	Grinsinger,
anze- zünde	anzezünde
fas- send):</stage>	fassend):</stage>
majon- naise,</emph>	majonnaise,</emph>
Waffe- stillstand	Waffestillstand
Auf- regung	Aufregung
zerück- kumme!</p>	zerückkumme!</p>
Grin- singer):	Grinsinger):
j'é- prouve!	j'éprouve!
deut- lich	deutlich
ver- sproche!	versproche!
herein- stürmend):</stage>	hereinstürmend):</stage>
Be- geeschterung	Begeeschterung
Kinder- wagen	Kinderwagen
ver- schaffen,	verschaffen,
Er- laubnis,	Erlaubnis,
allerunter- tänigsten	alleruntertänigsten
Bei- fall.)</stage>	Beifall.)</stage>
allergnä- digster	allergnädigster
Sachsen- bund	Sachsenbund
Sachsen- bund	Sachsenbund
Kon- serven	Konserven
alle- mands	allemands
beson- ders	besonders
freund- lichsten	freundlichsten
Zu- stimmung.)</stage>	Zustimmung.)</stage>
Völ- kern	Völkern
ge- sagt.	gesagt.
selbstver- ständlich	selbstverständlich
be- geistert	begeistert
re- cevez	recevez
vrai- ment	vraiment
Grin- singer	Grinsinger
Grin- singer	Grinsinger
Bei- spiel	Beispiel
com- patriote!</emph></p>	compatriote!</emph></p>
Cou- rage.	Courage.
ein- stürmen):</stage>	einstürmen):</stage>
Gänseleber- pastete?!	Gänseleberpastete?!
ge- horsamst	gehorsamst
rend="italic">Grin- singer</emph>	rend="italic">Grinsinger</emph>
Mit- glieder	Mitglieder
mitge- teilt	mitgeteilt
be- kannten	bekannten
unum- wunden	unumwunden
Instruk- tion!	Instruktion!
Sachse- bund?	Sachsebund?
be- dytte?	bedytte?
Grin- singer,	Grinsinger,
da- steht):</stage>	dasteht):</stage>
ver- lore!</p>	verlore!</p>
Lands- leute	Landsleute
zeruck- zehalte.</p>	zeruckzehalte.</p>
Ver- wunderung	Verwunderung
Vater- land	Vaterland
Mit- glied	Mitglied
unange- bracht,	unangebracht,
Staats- streich	Staatsstreich
Ge- sinnung?!	Gesinnung?!
zu- sammen!	zusammen!
nieder- zulegen	niederzulegen
fa- meux!</emph>	fameux!</emph>
Mit- gliedern	Mitgliedern
Un- ruhe	Unruhe
Geburts- scheine)</stage>.	Geburtsscheine)</stage>.
<stage>(All- gemeine	<stage>(Allgemeine
Geburts- schien	Geburtsschien
Ge- burtsschein)</stage>.	Geburtsschein)</stage>.
patrio- tische-n-Illüsione!</p>	patriotische-n-Illüsione!</p>
un- gerechter	ungerechter
rend="italic">commu- nauté	rend="italic">communauté
hei- ratet,	heiratet,
Berschbek- dife	Berschbekdife
Ge- miedhe,	Gemiedhe,
Nach- kommen	Nachkommen
ver- haftet.	verhaftet.
abge- führt):</stage>	abgeführt):</stage>
prote- stiere,	protestiere,
